1.ox
...o...ooo.o
o.ooo.....o.
o.oo.oo.oo.o
oo.o...ooooo
....o...o..o
..o..oo.o..o
.o..oo....oo
o.o.ooo.o...
o.o..o..oo.o
o.ooo.....o.
