111111111111111111111111
10000000M000M000M0000C01
100M001110M1110000P00001
1M1100001001M00100000011
10C100M01001000100M00011
111111101C01000100111111
111000M0111110C1001C0011
1C0010100000M11000100M11
1111101110010000M0110001
10M00M110001000000M00001
110001111111M00111111111
10M01111100000M000M00001
100000C1000M00E000M0C001
111111111111111111111111