111111111111111111111111
10000000M000M000M0000001
100M00100001110000P00001
1M1100001001000100000011
100100M00001000100M00011
11110000100100010000C011
111100M01001100100100011
100100000000M11000100011
1111101010010000M0100001
10M00M110001000000M00001
110001111111M00111111111
10M01010100100M000M00001
10000011000100E000M00001
111111111111111111111111