1111111111111
1000000000001
1000M00001C01
1000000001001
1E00M000010P1
1111111111111